# 《魔法學院的閃現天才》譯名對照表

## 人物
백유설 → 白流雪 (主角，只會閃現魔法的騎士)
에이젤 모르프 → 阿伊杰·莫爾法 (重要角色)
홍비연 → 洪飛燕 (強大的火系法師)
마유성 → 馬游星 (一年級最強者)
풀레임 → 普雷茵 (控制系能力出眾的法師)
신화련 → 申華蓮 (擅長單體攻擊的法師)
아달렌 → 阿達倫 (擅長單體攻擊的法師)
바이첸 → 拜臣 (怪獸學者)
재키 → 杰西 (配角)
사예란 오르칸 → 莎耶蘭．歐爾康
해원량 → 海元良
아돌레비트 → 阿多列維特

## 魔物名稱
하이머 라둔 → 海默拉頓
모래갈기 흑우 → 黑沙鬃獸
케이든 → 凱登
나미 슬라임 → 納米史萊姆
센시티브 배트 → 感知蝙蝠
무그레이카 → 穆格雷卡

## 地名與組織
스텔라 아카데미 → 史黛拉學院 (故事主要場景)
아이테르 월드 → 艾特爾世界 (故事背景世界)

## 建築物
제1본탑 → 第一主塔

## 職業與身份
나이트 → 騎士
비숍 → 主教
마법사 → 法師
네크로맨서 → 死靈法師

## 技能名稱
점멸 → 閃現
크리스탈 플라워 → 水晶之花

## 稱號
겨울의 여제 → 冬之女帝

## 特殊用語
콘스텐라티오 프로젝트 → 星座計畫